4887550845
5332905886
4410391931
4186044982
3210942082
3713128620
2376882394
3743613298
4225573462
5898767512
4484373011
2728018313
870449406
2518930648
3263528295
3234034472
1346003800
1422349525
1406023272
2445956294
2547854200
2690232419
1837787491
2614443337
2641632276
2885213278
1156690552
2846943923
3098305101
4086344673
3817050550
3690888651
2976799616
1784991537
1434482689
1892774402
3350636509
3811365083
3488904053
3281242676
3267681653
3678309769
3861777342
4138131059
4049756770
2830338342
3077198236
3248276922
4252687868
4483221509
3546749569
2505574772
2878486633
3237053414
2972534463
1225151614
1827299396
1981741367
1924611890
2778120850
3920602393
5741662440
4321525853
2602434714
1084203034
1461041248
2347725469
2287355896
3124922683
3689145874
3421114924
2097637040
925004700
840441324
1940800806
2827277824
3670779667
2870515394
1780587450
1481016591
911285960
1032369725
1839107718
3789772595
4269423140
4811642181
2867440561
3949238888
2498416253
2644568804
2432392443
2124051350
1943780300
311467352
431518768
880499686
1772508600
2779244238
